WMU,Year,Active_Hunters,Antlered_Harvest,Antlerless_Harvest,Total_Harvest
1C,2009,0,0,0,0
1C,2010,0,0,0,0
1C,2011,107,0,0,0
1C,2012,0,0,0,0
1C,2013,41,0,0,0
1C,2014,65,0,0,0
1C,2015,40,0,0,0
1C,2016,23,7,0,7
1C,2017,56,0,0,0
1C,2018,66,3,0,3
2,2009,51,0,0,0
2,2010,86,0,0,0
2,2011,113,0,0,0
2,2012,30,0,0,0
2,2013,48,2,0,2
2,2014,9,0,0,0
2,2015,24,0,0,0
2,2016,72,0,0,0
2,2017,167,0,0,0
2,2018,57,23,0,23
3,2008,457,99,47,146
3,2009,506,80,37,117
3,2010,339,63,40,103
3,2011,523,36,15,51
3,2012,238,18,42,60
3,2013,386,38,25,63
3,2014,244,19,0,19
3,2015,214,4,6,10
3,2016,345,5,3,8
3,2017,335,13,6,19
3,2018,305,2,0,2
4,2008,194,5,0,5
4,2009,169,21,0,21
4,2010,180,32,2,34
4,2011,102,21,0,21
4,2012,198,31,5,36
4,2013,145,3,6,9
4,2014,209,2,0,2
4,2015,188,3,2,5
4,2016,230,0,3,3
4,2017,68,0,2,2
4,2018,121,0,0,0
5,2008,1207,228,193,421
5,2009,1398,249,230,479
5,2010,1100,215,258,473
5,2011,1255,216,200,416
5,2012,1399,349,314,663
5,2013,1392,168,108,276
5,2014,925,73,89,162
5,2015,995,46,44,90
5,2016,979,39,43,82
5,2017,739,70,103,173
5,2018,843,58,29,87
6,2008,254,20,46,66
6,2009,251,40,30,70
6,2010,184,15,46,61
6,2011,181,14,39,53
6,2012,270,73,61,134
6,2013,236,6,41,47
6,2014,256,27,49,76
6,2015,291,56,0,56
6,2016,192,11,23,34
6,2017,294,5,13,18
6,2018,218,7,2,9
7A,2008,146,20,3,23
7A,2009,59,16,5,21
7A,2010,53,16,0,16
7A,2011,109,19,10,29
7A,2012,70,30,0,30
7A,2013,130,48,11,59
7A,2014,104,21,0,21
7A,2015,100,48,0,48
7A,2016,93,30,2,32
7A,2017,104,37,8,45
7A,2018,95,10,7,17
7B,2008,1981,833,1111,1944
7B,2009,1887,797,625,1422
7B,2010,2048,841,833,1674
7B,2011,1624,348,571,919
7B,2012,2062,856,903,1759
7B,2013,1858,481,527,1008
7B,2014,1802,472,333,805
7B,2015,1556,325,234,559
7B,2016,1687,467,263,730
7B,2017,1731,489,336,825
7B,2018,1510,477,310,787
8,2008,1394,571,635,1206
8,2009,1352,601,453,1054
8,2010,1394,624,592,1216
8,2011,1475,543,605,1148
8,2012,1552,608,696,1304
8,2013,1587,607,693,1300
8,2014,1153,396,476,872
8,2015,1453,470,514,984
8,2016,1654,485,577,1062
8,2017,1620,557,767,1324
8,2018,1584,424,572,996
9A,2008,549,51,125,176
9A,2009,520,103,64,167
9A,2010,513,49,91,140
9A,2011,426,56,58,114
9A,2012,469,52,88,140
9A,2013,324,12,53,65
9A,2014,242,22,13,35
9A,2015,321,43,15,58
9A,2016,353,19,5,24
9A,2017,297,19,8,27
9A,2018,364,16,9,25
9B,2008,1011,292,306,598
9B,2009,1066,215,242,457
9B,2010,887,260,260,520
9B,2011,943,267,233,500
9B,2012,1222,279,277,556
9B,2013,1142,247,173,420
9B,2014,733,49,56,105
9B,2015,584,71,77,148
9B,2016,701,85,83,168
9B,2017,979,219,174,393
9B,2018,888,188,126,314
10,2008,2699,1217,1462,2679
10,2009,2428,985,1099,2084
10,2010,2410,982,1111,2093
10,2011,2476,921,980,1901
10,2012,2776,1233,1139,2372
10,2013,2679,891,976,1867
10,2014,1860,445,409,854
10,2015,2148,850,361,1211
10,2016,2032,770,413,1183
10,2017,2112,831,469,1300
10,2018,2176,681,544,1225
11A,2008,492,106,112,218
11A,2009,537,112,106,218
11A,2010,367,141,96,237
11A,2011,417,113,127,240
11A,2012,419,84,116,200
11A,2013,440,52,81,133
11A,2014,374,56,23,79
11A,2015,406,103,17,120
11A,2016,423,114,41,155
11A,2017,415,70,83,153
11A,2018,366,78,67,145
11B,2008,200,0,7,7
11B,2009,136,3,5,8
11B,2010,164,4,4,8
11B,2011,176,26,3,29
11B,2012,112,22,0,22
11B,2013,76,0,0,0
11B,2014,100,3,0,3
11B,2015,211,28,0,28
11B,2016,258,40,0,40
11B,2017,173,22,3,25
11B,2018,156,23,4,27
12A,2008,81,2,2,4
12A,2009,119,0,0,0
12A,2010,97,2,6,8
12A,2011,93,22,9,31
12A,2012,87,0,0,0
12A,2013,87,0,0,0
12A,2014,58,0,0,0
12A,2015,74,0,0,0
12A,2016,102,5,5,10
12A,2017,100,0,0,0
12A,2018,29,0,0,0
12B,2008,611,65,54,119
12B,2009,655,67,52,119
12B,2010,457,54,70,124
12B,2011,483,48,65,113
12B,2012,531,23,79,102
12B,2013,429,82,22,104
12B,2014,382,75,13,88
12B,2015,583,18,31,49
12B,2016,447,50,24,74
12B,2017,538,49,27,76
12B,2018,374,15,21,36
13,2008,3281,1032,715,1747
13,2009,3251,1009,671,1680
13,2010,3273,922,698,1620
13,2011,3128,1076,792,1868
13,2012,4170,1481,1100,2581
13,2013,4383,1476,809,2285
13,2014,3698,1074,1027,2101
13,2015,4005,1246,933,2179
13,2016,4642,1405,901,2306
13,2017,4391,1380,943,2323
13,2018,4708,1300,834,2134
14,2008,17,10,10,20
14,2009,96,52,2,54
14,2010,40,4,4,8
14,2011,14,0,3,3
14,2012,104,0,0,0
14,2013,11,0,0,0
14,2014,79,17,0,17
14,2015,7,0,0,0
14,2016,0,0,0,0
14,2017,0,0,0,0
14,2018,2,0,0,0
15A,2008,217,0,3,3
15A,2009,199,3,0,3
15A,2010,160,2,0,2
15A,2011,107,0,2,2
15A,2012,47,0,2,2
15A,2013,35,0,2,2
15A,2014,88,0,0,0
15A,2015,91,0,0,0
15A,2016,48,0,0,0
15A,2017,73,0,0,0
15A,2018,73,0,0,0
15B,2008,485,5,11,16
15B,2009,601,22,3,25
15B,2010,495,22,7,29
15B,2011,409,0,5,5
15B,2012,433,5,12,17
15B,2013,332,0,4,4
15B,2014,329,2,2,4
15B,2015,477,0,0,0
15B,2016,385,0,7,7
15B,2017,280,2,3,5
15B,2018,308,0,0,0
16A,2009,11,0,0,0
16A,2010,6,0,0,0
16A,2011,6,2,0,2
16A,2012,0,0,0,0
16A,2013,18,0,0,0
16A,2014,0,0,0,0
16A,2015,20,0,0,0
16A,2016,18,0,0,0
16A,2017,3,0,0,0
16A,2018,18,0,0,0
16B,2009,24,16,0,16
16B,2010,12,0,0,0
16B,2011,13,0,0,0
16B,2012,3,0,0,0
16B,2013,22,4,0,4
16B,2014,0,0,0,0
16B,2015,7,0,0,0
16B,2016,11,0,0,0
16B,2017,37,0,0,0
16B,2018,37,0,0,0
16C,2009,22,0,0,0
16C,2010,0,0,0,0
16C,2011,6,0,0,0
16C,2012,0,0,0,0
16C,2013,4,0,0,0
16C,2014,0,0,0,0
16C,2015,0,0,0,0
16C,2016,4,0,0,0
16C,2017,0,0,0,0
16C,2018,2,0,0,0
17,2009,19,0,0,0
17,2010,39,0,0,0
17,2011,8,0,0,0
17,2012,4,6,0,6
17,2013,9,0,0,0
17,2014,40,0,0,0
17,2015,10,0,0,0
17,2016,14,0,0,0
17,2017,65,35,0,35
17,2018,11,0,0,0
18A,2009,38,0,0,0
18A,2010,22,0,0,0
18A,2011,21,0,0,0
18A,2012,29,0,0,0
18A,2013,42,0,0,0
18A,2014,7,0,0,0
18A,2015,29,23,0,23
18A,2016,99,0,0,0
18A,2017,17,3,0,3
18A,2018,69,5,0,5
18B,2009,0,0,0,0
18B,2010,0,0,0,0
18B,2011,0,0,0,0
18B,2012,0,0,0,0
18B,2013,6,0,0,0
18B,2014,0,0,0,0
18B,2015,0,0,0,0
18B,2016,0,2,0,2
18B,2017,0,0,0,0
18B,2018,11,0,0,0
19,2009,69,13,0,13
19,2010,19,0,3,3
19,2011,15,0,2,2
19,2012,92,0,0,0
19,2013,31,1,0,1
19,2014,17,0,0,0
19,2015,140,36,0,36
19,2016,45,0,0,0
19,2017,57,7,0,7
19,2018,85,0,0,0
21A,2008,264,16,14,30
21A,2009,346,2,9,11
21A,2010,311,17,6,23
21A,2011,244,2,5,7
21A,2012,293,5,12,17
21A,2013,285,3,18,21
21A,2014,220,3,0,3
21A,2015,248,30,0,30
21A,2016,151,4,3,7
21A,2017,214,0,0,0
21A,2018,251,0,0,0
21B,2009,38,0,0,0
21B,2010,83,0,0,0
21B,2011,33,0,0,0
21B,2012,70,0,0,0
21B,2013,8,0,0,0
21B,2014,0,0,0,0
21B,2015,123,0,0,0
21B,2016,60,0,0,0
21B,2017,51,17,0,17
21B,2018,35,0,0,0
22,2009,0,0,0,0
22,2010,0,0,0,0
22,2011,3,0,0,0
22,2012,27,0,0,0
22,2013,0,0,0,0
22,2014,0,0,0,0
22,2015,0,0,0,0
22,2016,7,0,0,0
22,2017,0,0,0,0
22,2018,23,0,0,0
23,2009,7,0,0,0
23,2010,6,0,0,0
23,2011,6,0,0,0
23,2012,11,0,0,0
23,2013,12,0,0,0
23,2014,2,0,0,0
23,2015,0,0,0,0
23,2016,15,0,0,0
23,2017,15,3,0,3
23,2018,26,0,0,0
24,2009,22,0,0,0
24,2010,1,0,0,0
24,2011,2,0,0,0
24,2012,11,0,0,0
24,2013,0,0,0,0
24,2014,7,0,0,0
24,2015,35,0,0,0
24,2016,23,0,0,0
24,2017,34,0,0,0
24,2018,18,0,0,0
25,2009,2,0,0,0
25,2010,40,0,1,1
25,2011,0,0,0,0
25,2012,7,0,0,0
25,2013,0,0,0,0
25,2014,0,0,0,0
25,2015,8,0,0,0
25,2016,20,0,0,0
25,2017,21,4,0,4
25,2018,0,0,0,0
26,2009,46,38,0,38
26,2010,3,0,0,0
26,2011,3,0,0,0
26,2012,6,0,0,0
26,2013,0,0,0,0
26,2014,0,0,0,0
26,2015,19,0,0,0
26,2016,4,0,0,0
26,2017,6,0,0,0
26,2018,20,0,0,0
27,2009,1,0,0,0
27,2010,33,22,0,22
27,2011,0,3,0,3
27,2012,0,0,0,0
27,2013,9,0,0,0
27,2014,10,0,0,0
27,2015,3,0,0,0
27,2016,36,0,0,0
27,2017,22,4,0,4
27,2018,34,0,0,0
28,2008,323,56,9,65
28,2009,172,4,0,4
28,2010,140,4,2,6
28,2011,162,2,2,4
28,2012,155,6,6,12
28,2013,120,0,3,3
28,2014,83,0,14,14
28,2015,168,2,0,2
28,2016,106,2,2,4
28,2017,88,2,0,2
28,2018,180,50,8,58
29,2009,23,0,0,0
29,2010,48,0,0,0
29,2011,0,0,0,0
29,2012,13,6,0,6
29,2013,35,6,0,6
29,2014,4,0,0,0
29,2015,46,0,0,0
29,2016,71,2,0,2
29,2017,21,0,0,0
29,2018,25,0,0,0
30,2009,14,0,0,0
30,2010,2,0,0,0
30,2011,8,6,0,6
30,2012,29,0,0,0
30,2013,13,0,0,0
30,2014,38,0,0,0
30,2015,3,0,0,0
30,2016,15,0,0,0
30,2017,93,3,0,3
30,2018,16,0,0,0
31,2009,26,0,0,0
31,2010,8,0,0,0
31,2011,8,2,0,2
31,2012,13,0,0,0
31,2013,20,0,0,0
31,2014,2,0,0,0
31,2015,12,0,0,0
31,2016,77,30,0,30
31,2017,7,2,5,7
31,2018,27,0,0,0
34,2009,33,0,0,0
34,2010,0,0,0,0
34,2011,51,6,0,6
34,2012,15,11,0,11
34,2013,40,15,0,15
34,2014,15,0,0,0
34,2015,39,0,0,0
34,2016,70,5,0,5
34,2017,5,0,0,0
34,2018,73,16,0,16
35,2009,119,0,0,0
35,2010,73,2,0,2
35,2011,74,0,3,3
35,2012,83,5,0,5
35,2013,124,18,5,23
35,2014,39,4,0,4
35,2015,81,0,0,0
35,2016,87,0,0,0
35,2017,62,0,0,0
35,2018,47,5,0,5
36,2008,1668,154,233,387
36,2009,1682,91,137,228
36,2010,1703,264,114,378
36,2011,1670,315,188,503
36,2012,1622,287,187,474
36,2013,1623,158,213,371
36,2014,1459,86,121,207
36,2015,1466,110,176,286
36,2016,1545,263,137,400
36,2017,1586,231,172,403
36,2018,1492,230,169,399
37,2008,1896,169,172,341
37,2009,1952,67,104,171
37,2010,1626,100,75,175
37,2011,1450,154,108,262
37,2012,1464,155,147,302
37,2013,1435,144,107,251
37,2014,1312,164,125,289
37,2015,1457,120,70,190
37,2016,1446,160,84,244
37,2017,1407,143,136,279
37,2018,1297,177,170,347
38,2008,147,3,3,6
38,2009,83,9,0,9
38,2010,171,6,0,6
38,2011,228,32,0,32
38,2012,186,0,2,2
38,2013,81,8,4,12
38,2014,108,15,0,15
38,2015,157,15,7,22
38,2016,147,0,2,2
38,2017,134,7,10,17
38,2018,128,2,11,13
39,2008,728,84,45,129
39,2009,710,49,31,80
39,2010,791,59,25,84
39,2011,743,118,39,157
39,2012,933,165,30,195
39,2013,973,152,46,198
39,2014,815,127,49,176
39,2015,961,101,29,130
39,2016,1034,188,43,231
39,2017,1077,101,41,142
39,2018,938,106,50,156
40,2009,82,20,4,24
40,2010,59,0,0,0
40,2011,86,0,0,0
40,2012,30,22,0,22
40,2013,50,2,0,2
40,2014,29,4,0,4
40,2015,14,3,0,3
40,2016,67,0,0,0
40,2017,53,0,0,0
40,2018,45,4,0,4
41,2008,1339,238,108,346
41,2009,1433,190,75,265
41,2010,1534,202,80,282
41,2011,1344,173,90,263
41,2012,1530,247,109,356
41,2013,1351,240,128,368
41,2014,1393,90,126,216
41,2015,1735,200,99,299
41,2016,1828,114,74,188
41,2017,1629,150,85,235
41,2018,1328,148,53,201
42,2008,2627,463,160,623
42,2009,2822,515,138,653
42,2010,2734,475,173,648
42,2011,2929,536,208,744
42,2012,3201,644,166,810
42,2013,3445,607,152,759
42,2014,3042,528,162,690
42,2015,3052,375,223,598
42,2016,3432,615,206,821
42,2017,3202,414,191,605
42,2018,2975,366,196,562
43A,2008,1446,269,238,507
43A,2009,1184,244,192,436
43A,2010,1209,276,169,445
43A,2011,1107,147,145,292
43A,2012,1117,221,125,346
43A,2013,1240,274,139,413
43A,2014,1016,241,51,292
43A,2015,983,190,98,288
43A,2016,1255,198,118,316
43A,2017,1165,240,134,374
43A,2018,998,146,185,331
43B,2008,6218,1499,2236,3735
43B,2009,6172,1267,1571,2838
43B,2010,6086,1314,1280,2594
43B,2011,6181,1424,1267,2691
43B,2012,5963,1550,1318,2868
43B,2013,6081,1715,1195,2910
43B,2014,5618,1226,1245,2471
43B,2015,6507,1552,1447,2999
43B,2016,6131,1785,1350,3135
43B,2017,6472,1779,1747,3526
43B,2018,7185,1448,2332,3780
44,2008,178,80,51,131
44,2009,294,71,54,125
44,2010,213,97,37,134
44,2011,245,116,48,164
44,2012,153,54,33,87
44,2013,172,61,18,79
44,2014,166,25,6,31
44,2015,180,33,7,40
44,2016,143,17,6,23
44,2017,188,91,6,97
44,2018,132,67,4,71
45,2008,1544,244,156,400
45,2009,1570,155,173,328
45,2010,1309,175,170,345
45,2011,1418,371,227,598
45,2012,1367,296,229,525
45,2013,1480,221,294,515
45,2014,1258,166,198,364
45,2015,1373,182,144,326
45,2016,1452,229,159,388
45,2017,1512,328,187,515
45,2018,1395,244,176,420
46,2008,2191,385,397,782
46,2009,2213,304,277,581
46,2010,2113,315,288,603
46,2011,2274,446,456,902
46,2012,2410,506,412,918
46,2013,2412,475,505,980
46,2014,2170,253,129,382
46,2015,2292,336,163,499
46,2016,2225,376,139,515
46,2017,2212,333,146,479
46,2018,2424,251,154,405
47,2008,7257,1289,1712,3001
47,2009,7537,1290,1475,2765
47,2010,7612,1232,1609,2841
47,2011,7402,1302,1896,3198
47,2012,7145,1260,1569,2829
47,2013,7148,1391,1528,2919
47,2014,7041,707,1715,2422
47,2015,7040,631,1069,1700
47,2016,7541,676,772,1448
47,2017,7694,529,894,1423
47,2018,7169,603,773,1376
48,2008,2621,489,278,767
48,2009,2698,439,277,716
48,2010,2884,373,266,639
48,2011,2994,400,375,775
48,2012,3026,473,332,805
48,2013,2862,480,468,948
48,2014,2611,431,394,825
48,2015,3067,446,246,692
48,2016,3030,395,280,675
48,2017,2896,347,230,577
48,2018,2790,369,275,644
49,2008,4930,644,812,1456
49,2009,4945,503,482,985
49,2010,4920,493,623,1116
49,2011,5585,983,659,1642
49,2012,5390,898,877,1775
49,2013,5525,740,787,1527
49,2014,4787,467,328,795
49,2015,4968,339,303,642
49,2016,5605,590,300,890
49,2017,5039,273,276,549
49,2018,5062,265,228,493
50,2008,2131,245,187,432
50,2009,1969,188,138,326
50,2010,1822,158,207,365
50,2011,1860,317,168,485
50,2012,1969,342,260,602
50,2013,2260,370,179,549
50,2014,1874,241,116,357
50,2015,2192,189,75,264
50,2016,2052,208,46,254
50,2017,1751,172,69,241
50,2018,1697,144,70,214
53A,2008,3118,537,464,1001
53A,2009,3137,448,350,798
53A,2010,2938,498,294,792
53A,2011,2995,326,351,677
53A,2012,2584,528,393,921
53A,2013,3088,647,507,1154
53A,2014,2705,405,114,519
53A,2015,2511,370,96,466
53A,2016,3074,361,130,491
53A,2017,2470,285,113,398
53A,2018,2401,242,114,356
53B,2008,206,32,22,54
53B,2009,137,23,22,45
53B,2010,219,22,41,63
53B,2011,213,27,58,85
53B,2012,278,63,45,108
53B,2013,218,58,32,90
53B,2014,202,29,25,54
53B,2015,238,19,28,47
53B,2016,159,26,22,48
53B,2017,197,61,18,79
53B,2018,232,32,21,53
54,2008,1952,237,258,495
54,2009,1899,236,194,430
54,2010,2033,275,192,467
54,2011,1753,123,141,264
54,2012,1870,277,189,466
54,2013,1643,213,173,386
54,2014,1475,93,191,284
54,2015,1879,112,92,204
54,2016,1752,90,84,174
54,2017,1745,152,108,260
54,2018,1612,88,77,165
55A,2008,1437,227,128,355
55A,2009,1453,165,189,354
55A,2010,1446,109,188,297
55A,2011,1550,225,152,377
55A,2012,1506,202,167,369
55A,2013,1345,172,195,367
55A,2014,1306,62,110,172
55A,2015,1565,93,97,190
55A,2016,1407,135,120,255
55A,2017,1324,75,114,189
55A,2018,1231,103,83,186
55B,2008,2371,544,230,774
55B,2009,2540,396,176,572
55B,2010,2269,395,205,600
55B,2011,2353,397,230,627
55B,2012,2292,312,283,595
55B,2013,2612,564,243,807
55B,2014,2254,401,264,665
55B,2015,2258,304,199,503
55B,2016,2721,510,209,719
55B,2017,2625,391,231,622
55B,2018,2652,499,200,699
56,2008,3181,511,564,1075
56,2009,3305,361,374,735
56,2010,3096,335,485,820
56,2011,3247,377,415,792
56,2012,3165,547,347,894
56,2013,3128,404,397,801
56,2014,3050,292,347,639
56,2015,3147,164,307,471
56,2016,3467,458,217,675
56,2017,3219,346,298,644
56,2018,3350,439,273,712
57,2008,3994,625,555,1180
57,2009,4063,400,676,1076
57,2010,4284,439,646,1085
57,2011,3797,579,609,1188
57,2012,4022,600,595,1195
57,2013,4044,847,614,1461
57,2014,4035,678,554,1232
57,2015,3884,407,584,991
57,2016,4569,711,531,1242
57,2017,4510,677,573,1250
57,2018,4312,662,520,1182
58,2008,4946,734,577,1311
58,2009,4886,581,522,1103
58,2010,5189,654,629,1283
58,2011,5141,1006,576,1582
58,2012,4861,979,726,1705
58,2013,4856,995,843,1838
58,2014,4655,650,713,1363
58,2015,5011,781,587,1368
58,2016,5383,912,435,1347
58,2017,5177,763,527,1290
58,2018,5362,597,614,1211
59,2008,3240,737,479,1216
59,2009,3354,520,554,1074
59,2010,3781,626,461,1087
59,2011,3356,596,532,1128
59,2012,3215,526,536,1062
59,2013,3856,943,482,1425
59,2014,3648,578,504,1082
59,2015,3110,463,541,1004
59,2016,4081,943,533,1476
59,2017,3987,799,493,1292
59,2018,3840,661,425,1086
60,2008,8248,1032,1291,2323
60,2009,8519,1040,1181,2221
60,2010,7907,974,1019,1993
60,2011,7934,1418,1086,2504
60,2012,8579,1547,1051,2598
60,2013,8332,1640,1107,2747
60,2014,8557,1018,976,1994
60,2015,8981,1140,1192,2332
60,2016,9650,1607,1005,2612
60,2017,9139,1406,850,2256
60,2018,9287,1325,1003,2328
61,2008,4698,720,670,1390
61,2009,4737,515,487,1002
61,2010,4787,552,368,920
61,2011,4707,612,638,1250
61,2012,5004,755,534,1289
61,2013,5220,728,634,1362
61,2014,4964,403,466,869
61,2015,5151,452,492,944
61,2016,5702,685,460,1145
61,2017,5354,514,469,983
61,2018,5367,589,392,981
62,2008,3698,616,459,1075
62,2009,3624,488,369,857
62,2010,3631,423,329,752
62,2011,3549,602,384,986
62,2012,3379,570,359,929
62,2013,3660,623,384,1007
62,2014,3628,365,246,611
62,2015,3895,489,232,721
62,2016,4027,717,251,968
62,2017,4381,709,237,946
62,2018,4102,765,253,1018
63A,2008,6614,1020,1183,2203
63A,2009,6015,580,707,1287
63A,2010,5431,589,190,779
63A,2011,5785,791,603,1394
63A,2012,5535,1056,658,1714
63A,2013,5793,1009,730,1739
63A,2014,5684,608,519,1127
63A,2015,5319,722,609,1331
63A,2016,5880,1006,453,1459
63A,2017,6497,897,399,1296
63A,2018,6032,748,509,1257
63B,2008,1604,416,378,794
63B,2009,1870,317,210,527
63B,2010,1987,356,156,512
63B,2011,1680,358,251,609
63B,2012,1721,417,213,630
63B,2013,1619,421,221,642
63B,2014,1856,295,175,470
63B,2015,1556,203,162,365
63B,2016,2024,336,170,506
63B,2017,2089,380,179,559
63B,2018,1818,379,208,587
64A,2008,3176,670,623,1293
64A,2009,3258,574,344,918
64A,2010,2991,767,250,1017
64A,2011,2745,619,411,1030
64A,2012,2865,602,490,1092
64A,2013,3277,1061,527,1588
64A,2014,3520,891,400,1291
64A,2015,2802,562,390,952
64A,2016,3285,834,358,1192
64A,2017,3215,800,411,1211
64A,2018,2994,585,385,970
64B,2008,1369,287,238,525
64B,2009,1222,277,110,387
64B,2010,1206,225,52,277
64B,2011,1195,352,117,469
64B,2012,1192,341,71,412
64B,2013,1354,433,72,505
64B,2014,1113,259,58,317
64B,2015,1144,206,68,274
64B,2016,1463,439,73,512
64B,2017,1356,251,53,304
64B,2018,1168,308,68,376
65,2008,5750,1415,965,2380
65,2009,5927,1316,730,2046
65,2010,5190,1207,476,1683
65,2011,5792,1358,765,2123
65,2012,5909,1750,729,2479
65,2013,6077,1886,773,2659
65,2014,5519,1051,655,1706
65,2015,5587,1366,538,1904
65,2016,5662,1347,777,2124
65,2017,5952,1175,670,1845
65,2018,5389,947,743,1690
66A,2008,2512,451,441,892
66A,2009,2370,303,403,706
66A,2010,2161,379,159,538
66A,2011,2074,543,163,706
66A,2012,1903,325,246,571
66A,2013,2165,446,225,671
66A,2014,1956,295,168,463
66A,2015,1854,284,154,438
66A,2016,2103,500,147,647
66A,2017,2075,468,133,601
66A,2018,2357,348,141,489
66B,2008,68,0,0,0
66B,2009,14,2,0,2
66B,2010,31,3,0,3
66B,2011,27,0,0,0
66B,2012,23,0,0,0
66B,2013,44,0,0,0
66B,2014,14,0,0,0
66B,2015,64,8,2,10
66B,2016,44,12,0,12
66B,2017,108,3,0,3
66B,2018,50,0,0,0
67,2008,5626,1184,1027,2211
67,2009,5213,906,928,1834
67,2010,5117,1108,428,1536
67,2011,4662,882,449,1331
67,2012,4696,1445,277,1722
67,2013,5051,1418,291,1709
67,2014,4639,780,153,933
67,2015,4718,1137,171,1308
67,2016,5200,1406,373,1779
67,2017,5338,1558,329,1887
67,2018,5010,1425,328,1753
68A,2008,1654,356,185,541
68A,2009,1261,139,124,263
68A,2010,1321,197,78,275
68A,2011,1725,260,108,368
68A,2012,1137,225,93,318
68A,2013,1453,296,84,380
68A,2014,1287,206,60,266
68A,2015,1205,182,71,253
68A,2016,1579,311,94,405
68A,2017,1467,302,63,365
68A,2018,1606,277,92,369
68B,2008,2203,312,258,570
68B,2009,2061,230,233,463
68B,2010,1948,218,119,337
68B,2011,2262,332,142,474
68B,2012,2198,356,122,478
68B,2013,2183,396,117,513
68B,2014,2233,205,138,343
68B,2015,2098,394,134,528
68B,2016,2527,477,124,601
68B,2017,2323,401,139,540
68B,2018,2776,613,112,725
69A,2008,1943,271,323,594
69A,2009,1653,340,257,597
69A,2010,1612,219,202,421
69A,2011,1510,226,195,421
69A,2012,1569,311,160,471
69A,2013,1557,309,191,500
69A,2014,1634,212,192,404
69A,2015,1299,262,186,448
69A,2016,1621,208,273,481
69A,2017,1424,232,230,462
69A,2018,1853,417,255,672
69B,2008,334,64,53,117
69B,2009,335,27,46,73
69B,2010,391,126,33,159
69B,2011,383,110,45,155
69B,2012,392,69,60,129
69B,2013,353,94,101,195
69B,2014,300,107,70,177
69B,2015,317,79,71,150
69B,2016,397,57,65,122
69B,2017,412,99,48,147
69B,2018,412,131,58,189
70,2008,1970,259,272,531
70,2009,1809,197,167,364
70,2010,1537,185,131,316
70,2011,1485,111,98,209
70,2012,1427,92,123,215
70,2013,1568,178,119,297
70,2014,1380,136,108,244
70,2015,1098,132,89,221
70,2016,1696,260,102,362
70,2017,1556,135,136,271
70,2018,1448,168,137,305
71,2008,1277,195,185,380
71,2009,1386,182,196,378
71,2010,1133,186,165,351
71,2011,1310,206,137,343
71,2012,1351,220,100,320
71,2013,1372,220,90,310
71,2014,1065,122,111,233
71,2015,1181,276,86,362
71,2016,1336,156,86,242
71,2017,1289,170,102,272
71,2018,1450,286,119,405
72A,2008,1163,226,124,350
72A,2009,1426,270,145,415
72A,2010,1267,166,105,271
72A,2011,1247,164,122,286
72A,2012,1114,225,85,310
72A,2013,1284,343,149,492
72A,2014,1101,146,88,234
72A,2015,1390,230,103,333
72A,2016,1617,235,98,333
72A,2017,1337,221,70,291
72A,2018,1409,197,70,267
72B,2008,118,8,5,13
72B,2009,75,16,5,21
72B,2010,115,8,0,8
72B,2011,89,0,0,0
72B,2012,90,3,3,6
72B,2013,46,0,0,0
72B,2014,70,0,4,4
72B,2015,70,7,0,7
72B,2016,141,16,4,20
72B,2017,123,8,11,19
72B,2018,110,12,7,19
73,2008,3168,547,370,917
73,2009,3179,406,352,758
73,2010,2645,313,247,560
73,2011,2333,322,334,656
73,2012,2356,436,211,647
73,2013,2428,451,260,711
73,2014,2451,383,274,657
73,2015,2277,407,260,667
73,2016,2837,540,130,670
73,2017,2731,278,239,517
73,2018,2848,353,208,561
74A,2008,658,80,140,220
74A,2009,767,113,118,231
74A,2010,623,54,92,146
74A,2011,776,133,64,197
74A,2012,459,87,66,153
74A,2013,663,63,76,139
74A,2014,536,60,58,118
74A,2015,539,165,64,229
74A,2016,663,144,36,180
74A,2017,582,80,55,135
74A,2018,608,99,67,166
74B,2008,1117,258,200,458
74B,2009,970,162,173,335
74B,2010,1078,143,182,325
74B,2011,925,164,160,324
74B,2012,1059,140,166,306
74B,2013,1167,220,207,427
74B,2014,936,115,111,226
74B,2015,1025,114,123,237
74B,2016,1117,324,81,405
74B,2017,1062,209,79,288
74B,2018,1131,138,75,213
75,2008,1629,277,219,496
75,2009,1630,285,191,476
75,2010,1480,288,191,479
75,2011,1684,245,184,429
75,2012,1524,181,181,362
75,2013,1675,276,171,447
75,2014,1353,180,128,308
75,2015,1320,161,155,316
75,2016,1649,292,84,376
75,2017,1831,220,116,336
75,2018,1579,326,119,445
76,2008,3718,472,463,935
76,2009,3745,344,326,670
76,2010,3523,406,286,692
76,2011,3499,387,267,654
76,2012,3496,342,240,582
76,2013,3647,421,243,664
76,2014,3569,271,183,454
76,2015,3424,245,176,421
76,2016,3658,295,214,509
76,2017,3715,318,208,526
76,2018,3668,323,194,517
77,2008,2304,456,287,743
77,2009,2624,359,328,687
77,2010,2361,273,274,547
77,2011,2293,392,217,609
77,2012,2212,288,237,525
77,2013,2382,313,223,536
77,2014,2321,232,216,448
77,2015,2094,266,148,414
77,2016,2258,319,104,423
77,2017,2154,325,85,410
77,2018,2162,262,94,356
78,2008,2926,512,434,946
78,2009,2861,363,289,652
78,2010,2721,338,328,666
78,2011,2544,249,252,501
78,2012,2621,304,210,514
78,2013,2294,258,210,468
78,2014,2610,314,196,510
78,2015,2289,306,165,471
78,2016,2822,358,204,562
78,2017,2485,327,157,484
78,2018,2678,344,186,530
79,2008,742,171,75,246
79,2009,714,199,83,282
79,2010,782,139,114,253
79,2011,838,226,72,298
79,2012,844,138,105,243
79,2013,778,115,68,183
79,2014,822,99,38,137
79,2015,744,169,56,225
79,2016,998,130,76,206
79,2017,1040,131,54,185
79,2018,812,85,48,133
80,2008,4115,755,879,1634
80,2009,4219,664,756,1420
80,2010,4301,712,841,1553
80,2011,4288,752,770,1522
80,2012,4138,752,723,1475
80,2013,4456,819,749,1568
80,2014,4255,593,515,1108
80,2015,3118,673,583,1256
80,2016,3356,652,590,1242
80,2017,3319,543,505,1048
80,2018,3281,598,463,1061
81,2008,2281,534,398,932
81,2009,2454,484,328,812
81,2010,2563,406,369,775
81,2011,2264,429,280,709
81,2012,2511,503,360,863
81,2013,2362,437,369,806
81,2014,2294,275,188,463
81,2015,2353,295,225,520
81,2016,2373,347,197,544
81,2017,2534,403,183,586
81,2018,2359,367,193,560
82A,2008,6403,1681,2034,3715
82A,2009,6697,1521,1596,3117
82A,2010,6496,1124,1587,2711
82A,2011,5953,1081,1555,2636
82A,2012,5866,1191,1592,2783
82A,2013,6750,1864,1706,3570
82A,2014,5846,1081,1220,2301
82A,2015,6570,1374,1047,2421
82A,2016,7206,1476,1088,2564
82A,2017,7229,1377,1214,2591
82A,2018,6549,1404,1250,2654
82B,2008,918,221,247,468
82B,2009,1092,185,233,418
82B,2010,929,197,159,356
82B,2011,962,173,105,278
82B,2012,877,303,121,424
82B,2013,986,212,147,359
82B,2014,947,163,66,229
82B,2015,839,183,98,281
82B,2016,1024,263,139,402
82B,2017,975,203,138,341
82B,2018,1093,170,121,291
83A,2008,1127,116,94,210
83A,2009,1109,80,68,148
83A,2010,971,73,45,118
83A,2011,1030,97,52,149
83A,2012,773,98,30,128
83A,2013,902,198,41,239
83A,2014,925,56,21,77
83A,2015,788,56,28,84
83A,2016,911,123,26,149
83A,2017,929,132,19,151
83A,2018,781,90,25,115
84,2008,3077,828,778,1606
84,2009,3048,564,705,1269
84,2010,2904,699,610,1309
84,2011,3001,728,717,1445
84,2012,2947,741,577,1318
84,2013,2987,690,837,1527
84,2014,3044,562,625,1187
84,2015,3100,660,778,1438
84,2016,3973,886,785,1671
84,2017,3931,858,652,1510
84,2018,3838,844,753,1597
85,2008,4853,1049,1410,2459
85,2009,4848,991,1355,2346
85,2010,4906,1118,1536,2654
85,2011,4889,1150,1455,2605
85,2012,5013,1181,1543,2724
85,2013,5202,1241,1584,2825
85,2014,5341,990,1384,2374
85,2015,5687,1032,1526,2558
85,2016,6289,1452,1636,3088
85,2017,6298,1381,1489,2870
85,2018,5986,1048,1270,2318
86,2008,1512,331,409,740
86,2009,1544,285,454,739
86,2010,1643,355,462,817
86,2011,1673,349,432,781
86,2012,1642,340,421,761
86,2013,1768,477,484,961
86,2014,1818,317,339,656
86,2015,1906,388,376,764
86,2016,2570,594,449,1043
86,2017,2080,428,462,890
86,2018,2022,364,371,735
87,2008,2694,729,472,1201
87,2009,3053,691,511,1202
87,2010,2921,652,566,1218
87,2011,3056,688,511,1199
87,2012,3041,781,551,1332
87,2013,3164,784,580,1364
87,2014,3449,721,383,1104
87,2015,3272,728,332,1060
87,2016,3428,734,323,1057
87,2017,3164,555,332,887
87,2018,3076,445,287,732
88,2008,574,131,114,245
88,2009,563,143,115,258
88,2010,448,48,137,185
88,2011,452,74,125,199
88,2012,524,85,166,251
88,2013,559,137,170,307
88,2014,544,78,148,226
88,2015,499,83,19,102
88,2016,919,233,112,345
88,2017,777,161,143,304
88,2018,892,175,142,317
89,2008,4583,762,840,1602
89,2009,4631,712,821,1533
89,2010,4743,632,869,1501
89,2011,4345,687,790,1477
89,2012,4500,740,812,1552
89,2013,4804,708,706,1414
89,2014,4527,660,533,1193
89,2015,4674,687,522,1209
89,2016,5176,836,625,1461
89,2017,5054,786,563,1349
89,2018,5062,783,574,1357
90,2008,5402,904,959,1863
90,2009,5567,875,1093,1968
90,2010,5412,924,1159,2083
90,2011,5759,951,1141,2092
90,2012,5816,1051,1232,2283
90,2013,5983,895,1411,2306
90,2014,6039,1006,1176,2182
90,2015,6424,1267,1190,2457
90,2016,6971,1231,1190,2421
90,2017,6509,1078,1161,2239
90,2018,6211,1060,1022,2082
91,2008,2911,552,673,1225
91,2009,2825,544,527,1071
91,2010,2763,490,622,1112
91,2011,2618,489,516,1005
91,2012,2896,612,501,1113
91,2013,2996,548,588,1136
91,2014,3060,482,495,977
91,2015,3104,585,554,1139
91,2016,3313,632,463,1095
91,2017,3179,610,472,1082
91,2018,3171,557,483,1040
92,2008,5883,1405,2000,3405
92,2009,6034,1396,1531,2927
92,2010,5995,1389,1874,3263
92,2011,5942,1433,1647,3080
92,2012,6360,1375,1656,3031
92,2013,6231,1662,1678,3340
92,2014,6460,1583,1323,2906
92,2015,7057,1979,1425,3404
92,2016,7868,2003,1443,3446
92,2017,7581,1958,1469,3427
92,2018,8247,2058,1530,3588
93,2008,2399,429,638,1067
93,2009,2646,550,608,1158
93,2010,2592,538,656,1194
93,2011,2831,599,557,1156
93,2012,2694,598,614,1212
93,2013,2881,669,712,1381
93,2014,2866,608,540,1148
93,2015,3320,939,666,1605
93,2016,3685,940,677,1617
93,2017,3750,956,650,1606
93,2018,3475,855,735,1590
94,2008,1411,138,248,386
94,2009,1555,220,276,496
94,2010,1403,278,277,555
94,2011,1607,371,192,563
94,2012,1406,275,229,504
94,2013,1669,235,224,459
94,2014,1638,261,175,436
94,2015,1784,530,187,717
94,2016,2150,441,216,657
94,2017,2316,361,222,583
94,2018,2129,377,217,594
Total,2008,197659,37907,37991,75898
Total,2009,199583,32835,31297,64132
Total,2010,193100,32662,30130,62792
Total,2011,192468,35352,30776,66128
Total,2012,194008,39188,31847,71035
Total,2013,200629,41235,32065,73300
Total,2014,189394,28908,25013,53921
Total,2015,193742,32360,24374,56734
Total,2016,214313,39391,24196,63587
Total,2017,209221,35937,24945,60882
Total,2018,205594,33919,25013,58932
